WWWWWWWWWWW
W*********W
W*********W
W*********W
W*********W
W*********R
W*********W
W*********W
W*********W
W*********W
WWWWWWWWWWW

WWWWWWWWWWW
W*********W
W*********W
W**s******W
W*********W
W*********W
W******l**W
W*********W
W******a**W
W*********W
WWWWWWWWWWW
