BBWTWWWTWBB
BBW*****WBB
WWW*****WWW
T*********T
W*********W
W*********R
W*********W
T*********T
WWW*****WWW
BBW*****WBB
BBWTWWWTWBB

BBWTWWWTWBB
BBW*****WBB
WWW*****WWW
T*******l*T
W*********W
W*********R
W*********W
T*********T
WWW*****WWW
BBW*****WBB
BBWTWWWTWBB
