BBWTWWWTWBB
BBW*****WBB
WWW*****WWW
T*********T
W*********W
L*********W
W*********W
T*********T
WWW*****WWW
BBW*****WBB
BBWTWWWTWBB

BBWTWWWTWBB
BBW*****WBB
WWW*****WWW
T*********T
W*********W
L*********W
W*a*******W
T*********T
WWW*****WWW
BBW*****WBB
BBWTWWWTWBB
