WWWWWWTWWWB
WHW**HHH*WW
WHW*******W
WH******WWW
WWW*****H*W
T*******H*T
WHHH****H*W
WHHH***W**W
WW*****W**W
BWWTW*WWWWW
BBBBWDWBBBB

WWWWWWWWWBB
W*******WWB
W********WW
W**s******W
W*********W
WWW*****l*W
W*********W
WHH****a**W
WHHH******W
W*********W
WWWWWDWWWWW
