WWWWWWWWWWB
W*W******WW
W*W*******W
W*******WWW
WWW*******W
W*********W
WHH*******W
WHHH***W**W
WW*****W**W
BWWWW*WWWWW
BBBBWDWBBBB

WWWWWWWWWBB
W*******WWB
W********WW
W**s******W
W*********W
WWW*****l*W
W*********W
WHH****a**W
WHHH******W
W*********W
WWWWWDWWWWW
