WWWWWWTWWWB
WHW**HHH*WW
WHW*******W
WH******WWW
WWW*****H*W
T*******H*T
WHHH****H*W
WHHH***W**W
WW*****W**W
BWWTW*WWWWW
BBBBWDWBBBB

WWWWWWWWWWB
WHW**HHHcWW
WHW*******W
WH***b**WWW
WWW*****H*W
W****l**H*W
WHHH****H*W
WHHH*s*W**W
WW*****W**W
BWWWW*WWWWW
BBBBWDWBBBB
