WWWWWWWWWWW
W*********W
W*********W
W*********W
W*********W
W*********W
W*********W
W*********W
W*********W
W*********W
WWWWWDWWWWW
