WWWWWWWWWWW
W*********W
W*********W
W*********W
W*********W
W*********W
W*********W
W*********W
W*********W
W*********W
WWWWWDWWWWW

WWWWWWWWWWW
W*********W
W*********W
W**s******W
W*********W
W*********W
W*********W
W*********W
W******a**W
W*********W
WWWWWWWWWWW
