BBWTWWWTWBB
BBW*****WBB
WWW*****WWW
T*********T
W*********W
W*********W
W*********W
T*********T
WWW*****WWW
BBW*****WBB
BBWTWDWTWBB

BBWTWWWTWBB
BBW**s**WBB
WWW*****WWW
T*********T
W*********W
W*********W
W*********W
T*********T
WWW*****WWW
BBW*****WBB
BBWTWDWTWBB
