WWWWWWWWWWB
WHW**HHH*WW
WHW*******W
WH******WWW
WWW*****H*W
W*******H*W
WHHH****H*W
WHHH***W**W
WW*****W**W
BWWWW*WWWWW
BBBBWDWBBBB

WWWWWWWWWBB
W*******WWB
W********WW
W**s******W
W*********W
WWW*****l*W
W*********W
WHH****a**W
WHHH******W
W*********W
WWWWWDWWWWW
