WWWWWWTWWWB
WHW**HHH*WW
WHW*******W
WH******WWW
WWW*****H*W
T*******H*T
WHHH****H*W
WHHH***W**W
WW*****W**W
BWWTW*WWWWW
BBBBWDWBBBB

WWWWWWWWWWB
WHW**HHH*WW
WHW*******W
WH***n**WWW
WWW*****H*W
W*******H*W
WHHH****H*W
WHHH***W**W
WW*****W**W
BWWWW*WWWWW
BBBBWDWBBBB
