WWWWWUWWWWW
W*********W
W*********W
W*********W
W*********W
W*********W
W*********W
W*********W
W*********W
W*********W
WWWWWWWWWWW
