BBWTWUWTWBB
BBW*****WBB
WWW*****WWW
T*********T
W*********W
W*********W
W*********W
T*********T
WWW*****WWW
BBW*****WBB
BBWTWWWTWBB
