5 5
1 0 0 0 

WWDWW
W***W
W***W
W***W
WWWWW