WWWWWWWWWWW
W*********W
W*********W
W*********W
W*********W
W*********R
W*********W
W*********W
W*********W
W*********W
WWWWWWWWWWW 

WWWWWWWWWWW
W*********W
W*********W
W*********W
W*********W
W****b****R
W*********W
W*********W
W*********W
W*********W
WWWWWWWWWWW