WWWWWWWWWWW
W*********W
W*********W
W*********W
W*********W
W*********W
W*********W
W*********W
W*********W
W*********W
WWWWWDWWWWW 

WWWWWWWWWWW
W*********W
W*********W
W*********W
W*********W
W****b****W
W*********W
W*********W
W*********W
W*********W
WWWWWDWWWWW