WWWWW
W***W
W***R
W***W
WWDWW

WWWWW
W***W
W*b*R
W***W
WWDWW