WWWWW
W***W
L***W
W***W
WWDWW

WWWWW
W***W
L*b*W
W***W
WWDWW