WWWWWWWWWWW
W*********W
W*********W
W*********W
W*********W
L*********W
W*********W
W*********W
W*********W
W*********W
WWWWWDWWWWW 

WWWWWWWWWWW
W*********W
W*********W
W*********W
W*********W
L****b****W
W*********W
W*********W
W*********W
W*********W
WWWWWDWWWWW