WWWWWWWWWWW
W*********W
W*********W
W*********W
W*********W
L*********R
W*********W
W*********W
W*********W
W*********W
WWWWWDWWWWW 

WWWWWWWWWWW
W*********W
W*********W
W*********W
W*********W
L****b****R
W*********W
W*********W
W*********W
W*********W
WWWWWDWWWWW