WWWWWUWWWWW
W*********W
W*********W
W*********W
W*********W
W*********W
W*********W
W*********W
W*********W
W*********W
WWWWWWWWWWW 

WWWWWUWWWWW
W*********W
W*********W
W*********W
W*********W
W****b****W
W*********W
W*********W
W*********W
W*********W
WWWWWWWWWWW