WWUWW
W***W
W***R
W***W
WWWWW

WWUWW
W***W
W*b*R
W***W
WWWWW