WWUWW
W***W
L***W
W***W
WWWWW

WWUWW
W***W
L*b*W
W***W
WWWWW