BWWUWWB
WW***WW
W*****W
L*****R
W*****W
WWWWWWW
BBBBBBB

BWWUWWB
WW***WW
W*****W
L**b**R
W*****W
WWWWWWW
BBBBBBB