WWWWWUWWWWW
W*********W
W*********W
W*********W
W*********W
L*********R
W*********W
W*********W
W*********W
W*********W
WWWWWWWWWWW 

WWWWWUWWWWW
W*********W
W*********W
W*********W
W*********W
L****b****R
W*********W
W*********W
W*********W
W*********W
WWWWWWWWWWW