WWWWWUWWWWW
W*********W
W*********W
W*********W
W*********W
W*********W
W*********W
W*********W
W*********W
W*********W
WWWWWDWWWWW 

WWWWWUWWWWW
W*********W
W*********W
W*********W
W*********W
W****b****W
W*********W
W*********W
W*********W
W*********W
WWWWWDWWWWW