WWUWW
W***W
W***W
W***W
WWDWW

WWUWW
W***W
W*b*W
W***W
WWDWW