BWWWWWUWWWWB
BW*********W
BW*********W
BW*********W
BW*********W
BW*********R
BW*********W
BW*********W
BW*********W
BW*********W
BWWWWWDWWWWB

BWWWWWUWWWWB
BW*********W
BW*********W
BW*********W
BW*********W
BW****b****R
BW*********W
BW*********W
BW*********W
BW*********W
BWWWWWDWWWWB