BWWWWUWWWWWB
W*********WB
W*********WB
W*********WB
W*********WB
L*********WB
W*********WB
W*********WB
W*********WB
W*********WB
BWWWWDWWWWWB 
		   
WWWWWUWWWWWB
W*********WB
W*********WB
W*********WB
W*********WB
L****b****WB
W*********WB
W*********WB
W*********WB
W*********WB
WWWWWDWWWWWB