BBBWWUWWBBB
BWW*****WWB
BW*******WB
W*********W
W*********W
L*********R
W*********W
W*********W
BW*******WB
BWW*****WWB
BBBWWDWWBBB

BBBWWUWWBBB
BWW*****WWB
BW*******WB
W*********W
W*********W
L****b****R
W*********W
W*********W
BW*******WB
BWW*****WWB
BBBWWDWWBBB