WWWWW
W***W
L***R
W***W
WWWWW

WWWWW
W***W
L***R
W*s*W
WWWWW