WWWWW
W***W
W***R
W***W
WWDWW

WWWWW
Wl**W
W***R
W***W
WWDWW