WWWWW
W***W
L***W
W***W
WWDWW

WWWWW
W**aW
L***W
W***W
WWDWW