WWUWW
W***W
L***W
W***W
WWWWW

WWUWW
W***W
L***W
W**lW
WWWWW