WWUWW
W***W
W***W
W***W
WWDWW

WWUWW
W***W
W*s*W
W***W
WWDWW