BBWWUWWBB
BBW***WBB
WWW***WWW
W*******W
L***l***R
W*******W
WWW***WWW
BBW***WBB
BBWWDWWBB