15 15
0 0 0 1 

WWWWWWWWWWWWWWW
WW***********WW
W*************W
W*************W
W*************W
W*************W
W*************W
W*************R
W*************W
W*************W
W*************W
W*************W
W*************W
WW***********WW
WWWWWWWWWWWWWWW