WWWWWWWWWWWWWWW
WW***********WW
W*************W
W*************W
W*************W
W*************W
W*************W
L*************W
W*************W
W*************W
W*************W
W*************W
W*************W
WW***********WW
WWWWWWWWWWWWWWW

***************
***************
***************
***************
***************
***************
***************
*******1*******
***************
***************
***************
***************
***************
***************
***************