15 15
0 1 0 0 

WWWWWWWWWWWWWWW
WW***********WW
W*************W
W*************W
W*************W
W*************W
W*************W
W*************W
W*************W
W*************W
W*************W
W*************W
W*************W
WW***********WW
WWWWWWWDWWWWWWW