BBWWTWWWTWWBB
BBW*******WBB
BBW*******WBB
BBW**WTW**WBB
WTW**WBW**WTW
W****WBW****W
L****TBT****R
W****WBW****W
WTW**WBW**WTW
BBW**WTW**WBB
BBW*******WBB
BBW*******WBB
BBWWTWWWTWWBB

BBWWTWWWTWWBB
BBW***s***WBB
BBW*******WBB
BBW**WTW**WBB
WTW**WBW**WTW
W****WBW****W
L****TBT****R
W****WBW****W
WTW**WBW**WTW
BBW**WTW**WBB
BBW*******WBB
BBW***s***WBB
BBWWTWWWTWWBB