BWWWWTWWWWB
WW*******WW
W*********W
T***HH****R
W***HH****W
W***HH*WTWW
W***WWWWBBB
T******WBBB
W******WBBB
WWWW***WBBB
BBBWWDWWBBB
