BBBWWWWWWBB
WWTW****WBB
W*****W*WBB
W*HHHHW*WWW
W*HHHHW***T
T*****W*WWW
WWWWW*H***W
L*****H*W*W
WWWWWWH*W*W
W*******W*W
WWDWWWWWWTW