BBBWWWTWWWBBB
BBBW*****WBBB
BBBW*****WBBB
BBBT*****TBBB
BBBW*****WBBB
BBBW*****WBBB
BBBWW***WWBBB
BBBBW***WBBBB
BBBBT***TBBBB
BBBBW***WBBBB
WWWWW***WWWWW
L***********R
WWWTWWDWWTWWW

BBBWWWTWWWBBB
BBBW*****WBBB
BBBW*****WBBB
BBBTa****TBBB
BBBW*****WBBB
BBBW****aWBBB
BBBWW***WWBBB
BBBBW***WBBBB
BBBBT*l*TBBBB
BBBBW***WBBBB
WWWWW***WWWWW
L*****a****R
WWWTWWDWWTWWW