BBBBBBB
WWWWWWW
W*****W
L*****R
W*****W
WW***WW
BWWDWWB

BBBBBBB
WWWWWWW
W**u**W
L*****R
W*****W
WW***WW
BWWDWWB