BBBWWWTWWWBBB
BBBW*****WBBB
BBBW*****WBBB
BBBT*****TBBB
BBBW*****WBBB
BBBW*****WBBB
BBBWW***WWBBB
BBBBW***WBBBB
BBBBT***TBBBB
BBBBW***WBBBB
WWWWW***WWWWW
L***********R
WWWTWWDWWTWWW