BBBWWUWWBBB
WWWW***WBBB
W******WBBB
T******WBBB
W***WWWWBBB
W***HH*WTWW
W*s*HH****W
T***HH**a*R
W*********W
WW*******WW
BWWWWTWWWWB