BBBWWUWWBBB
WWWW***WBBB
W******WBBB
T******WBBB
W***WWWWBBB
W***HH*WTWW
W***HH****W
T***HH****R
W*********W
WW*******WW
BWWWWTWWWWB

BBBWWUWWBBB
WWWW***WBBB
W******WBBB
T*l****WBBB
W***WWWWBBB
W***HH*WTWW
W***HHs***W
T***HH****R
W*a*******W
WW*******WW
BWWWWTWWWWB