WWUWW
W***W
W***R
W***W
WWWWW

WWUWW
W***W
W***R
Ws**W
WWWWW