WWUWWWWWWTW
W*******W*W
WWWWWWH*W*W
L*****H*W*W
WWWWW*H***W
T*****W*WWW
W*HHHHW***T
W*HHHHW*WWW
W*****W*WBB
WWTW****WBB
BBBWWWWWWBB