WWWTWWUWWTWWW
L***********R
WWWWW***WWWWW
BBBBW***WBBBB
BBBBT***TBBBB
BBBBW***WBBBB
BBBWW***WWBBB
BBBW*****WBBB
BBBW*****WBBB
BBBT*****TBBB
BBBW*****WBBB
BBBW*****WBBB
BBBWWWTWWWBBB

WWWTWWUWWTWWW
L*****s*****R
WWWWW***WWWWW
BBBBW***WBBBB
BBBBT***TBBBB
BBBBW*a*WBBBB
BBBWW***WWBBB
BBBW*****WBBB
BBBW***s*WBBB
BBBTs****TBBB
BBBW*****WBBB
BBBW*****WBBB
BBBWWWTWWWBBB