BBBBWWUWWBBBB
BBBBW***WBBBB
WWWWW***WWWWW
W***********W
T***********T
W**WWWTWWW**W
W**TBBBBBT**W
W**WWWTWWW**W
T***********T
W***********W
WWWWW***WWWWW
BBBBW***WBBBB
BBBBWWDWWBBBB

BBBBWWUWWBBBB
BBBBW***WBBBB
WWWWW***WWWWW
W*****a*****W
T***********T
W**WWWTWWW**W
W**TBBBBBT**W
W**WWWTWWW**W
T***********T
W*****a*****W
WWWWW***WWWWW
BBBBW***WBBBB
BBBBWWDWWBBBB