BBBBWWUWWBBBB
BBBBW***WBBBB
WWWWW***WWWWW
W***********W
T***********T
W**WWWTWWW**W
W**TBBBBBT**W
W**WWWTWWW**W
T***********T
W***********W
WWWWW***WWWWW
BBBBW***WBBBB
BBBBWWDWWBBBB