WWUWWWTWWBB
W*******WBB
W*******WBB
WWWWWW**WWW
W*********T
T*********R
W*********T
WWWWWW**WWW
W*******WBB
W*******WBB
WWDWWWTWWBB

WWUWWWTWWBB
W***s***WBB
W*******WBB
WWWWWW**WWW
W*********T
T****l****R
W*********T
WWWWWW**WWW
W*******WBB
W***s***WBB
WWDWWWTWWBB