BBWWTWWWUWW
BBW*******W
BBW*******W
WWW**WWWWWW
T*********W
L*********T
T*********W
WWW**WWWWWW
BBW*******W
BBW*******W
BBWWTWWWDWW