BBWWTWWWUWW
BBW*******W
BBW*******W
WWW**WWWWWW
T*********W
L*********T
T*********W
WWW**WWWWWW
BBW*******W
BBW*******W
BBWWTWWWDWW

BBWWTWWWUWW
BBW*a*****W
BBW*******W
WWW**WWWWWW
T*********W
L****l****T
T*********W
WWW**WWWWWW
BBW*a*****W
BBW*******W
BBWWTWWWDWW