WWWTWWUWWTWWW
L***********R
WWWWW***WWWWW
BBBBW***WBBBB
BBBBT***TBBBB
BBBBW***WBBBB
BBBWW***WWBBB
BBBW*****WBBB
BBBW*****WBBB
BBBT*****TBBB
BBBW*****WBBB
BBBW*****WBBB
BBBWWWDWWWBBB

WWWTWWUWWTWWW
L***********R
WWWWW***WWWWW
BBBBW***WBBBB
BBBBT*l*TBBBB
BBBBW***WBBBB
BBBWW***WWBBB
BBBW*****WBBB
BBBW*****WBBB
BBBT*l****TBBB
BBBW*****WBBB
BBBW*****WBBB
BBBWWWDWWWBBB