WWWWWWUWWWBBB
W********WBBB
W**WWW***WBBB
WW*******WWWB
BW*********WB
WW***HHH***WW
L****HHH****R
WW***HHH***WW
BW*********WB
BWWW*******WW
BBBW***WWW**W
BBBW********W
BBBWWWDWWWWWW

WWWWWWUWWWBBB
Ws*******WBBB
W**WWW***WBBB
WW*******WWWB
BW*l**a****WB
WW***HHH***WW
L****HHH****R
WW***HHH***WW
BW****a****WB
BWWW*******WW
BBBW***WWW**W
BBBW*******sW
BBBWWWDWWWWWW