5 5
1 0 0 1

WWUWW
W***W
W***R
W***W
WWWWW