5 5
1 0 0 1

WWDWW
W***W
W***D
W***W
WWWWW