5 5
1 1 0 0 

WWUWW
W***W
W***W
W***W
WWDWW