9 9
1 1 1 1

BBWWUWWBB
BBW***WBB
WWW***WWW
W*******W
D*******R
W*******W
WWW***WWW
BBW***WBB
BBWWLWWBB